11111111111111111111111111111111111111111
1000000010001000000000000000000000000C001
1000001010P010000011100001111111110000001
10000101110110000110000001100000000000001
100010001000000010000C0001100C00000000001
100111111100000100C0000001111111010011011
10100000001000001000000001100000010010001
1101110000010000110000001100C001010010E01
100101000000101C1001110001111111110010001
11111111111111111111111111111111111111111