11111111111111111111111111111111111111111
100000000P000000000000000000000000000C001
10000010000000000011100001111111110000001
10000101000000000110000001100000000000001
100010001000000010000C0001100C00000000001
100111111100000100C00000011111111000C0001
10100000001000001000000001100000000000001
11000000000100000110000001100C00000000001
100000000000100C00011100011111111100000E1
11111111111111111111111111111111111111111