11111111111111111111111111111111111111111
1C0C0C0C0C0C0C0C0C0C0C0C0C0C0C0C0C0C0C001
10000010000000000011100001111111110000001
10000101000000000110000001100000000000001
10001000100000001000000001100000000000001
10011111110000010000000001111111100000001
1010000000100000100000000110000000P000001
110000000001000001100000011000000000C0001
100000000000100000011100011111111100000E1
10000000000000000000000000000000000000001
11111111111111111111111111111111111000001
10000000000100000010000000000000001000001
10001000000100000010000000100000001000001
10C01000000100000000000000100000001000001
10001000000000000000000000100000000000001
11111111111111111111111111111111111111111
