11111111111111111111111111111111111111111
1000000010001000000000000000000000000C001
1000001010P010000011100001111111110000001
10000101110110000110000001100000000000001
100010001000000010000C0001100C00000000001
100111111100000100C00000011111111000C0001
10100000001000001000000001100000000000001
1100000000010000110000001100C000000000001
100000000000101C10011100011111111100001E1
11111111111111111111111111111111111111111