11111111111111111111111111111111111111111
10000000000000000000000000000000000000001
100000100000000000111000011111111100S0001
100001010000000001100000011000000000S0001
10001000100000001000000001100000000000001
10011111110000010000000001111111100000001
10100000001000001000000001100000000000001
11000000000100000110000001100000000CC00P1
100000000000100000011100011111111100000E1
11111111111111111111111111111111111111111