11111111111111111111111111111111111111111
10000000000000000000000000000000000000001
100000100000000000111000011111111100S0001
100001010000000001100000011000000000S0001
10001000100000001000000001100000SSSSS0S01
10011111110000010000000001111111100S0S001
10100000001000001000000001100000000S00001
11000000000100000110000001100000000CC0P01
100000000000100000011100011111111100000E1
10000000000000000000000000000000000000001
11111111111111111111111111111111111000001
10000000000100000010000000000000001000001
10001000000100000010000000100000001000001
10C01000000100000000000000100000001000001
10001000000000000000000000100000000000001
11111111111111111111111111111111111111111